[
  {
    "solution": [18, 15, 20, 28, 10, 24, 14, 12, 21],
    "hints": [
      [0, 0, 20, 0, 10, 0, 14, 0, 0],
      [18, 1, 1, 1, 0, 1, 1, 1, 21],
      [1, 15, 1, 28, 0, 24, 1, 0, 1]
    ]
  },
  {
    "solution": [21, 14, 10, 24, 28, 12, 15, 18, 20],
    "hints": [
      [21, 0, 10, 0, 0, 0, 0, 18, 0],
      [1, 0, 1, 0, 28, 0, 1, 0, 1],
      [1, 1, 1, 1, 14, 1, 24, 1, 12],
      [1, 1, 1, 0, 0, 0, 15, 0, 20]
    ]
  },
  {
    "solution": [15, 24, 10, 21, 12, 28, 18, 20, 14],
    "hints": [
      [5, 24, 0, 0, 0, 28, 6, 20, 0],
      [0, 0, 10, 7, 12, 0, 0, 0, 14]
    ]
  },
  {
    "solution": [21, 10, 12, 15, 18, 14, 20, 24, 28],
    "hints": [
      [21, 0, 12, 0, 3, 0, 5, 6, 7],
      [1, 1, 1, 1, 10, 1, 15, 6, 14]
    ]
  },
  {
    "solution": [10, 14, 18, 15, 20, 12, 24, 28, 21],
    "hints": [
      [2, 7, 3, 3, 5, 6, 0, 7, 3],
      [1, 1, 6, 1, 20, 1, 24, 1, 1],
      [5, 2, 3, 5, 0, 2, 0, 4, 0]
    ]
  },
  {
    "solution": [10, 24, 15, 12, 28, 18, 20, 21, 14],
    "hints": [
      [1, 1, 1, 12, 0, 1, 1, 0, 14],
      [1, 1, 1, 1, 0, 18, 0, 21, 1],
      [1, 15, 1, 1, 0, 1, 0, 0, 1],
      [1, 1, 0, 1, 28, 1, 0, 1, 1],
      [10, 1, 1, 1, 0, 1, 1, 1, 0],
      [0, 24, 1, 1, 1, 0, 1, 1, 1]
    ]
  },
  {
    "solution": [15, 24, 14, 21, 20, 10, 12, 28, 18],
    "hints": [
      [3, 4, 0, 0, 5, 10, 6, 0, 3],
      [1, 1, 1, 1, 21, 20, 1, 1, 1],
      [1, 1, 1, 5, 24, 14, 1, 1, 1]
    ]
  },
  {
    "solution": [18, 20, 15, 12, 14, 28, 10, 24, 21],
    "hints": [
      [0, 4, 1, 0, 0, 1, 10, 4, 1],
      [0, 14, 28, 0, 0, 3, 1, 1, 1],
      [1, 1, 1, 18, 0, 15, 1, 1, 1],
      [0, 1, 1, 6, 1, 1, 0, 6, 3]
    ]
  },
  {
    "solution": [24, 10, 20, 18, 15, 21, 28, 12, 14],
    "hints": [
      [0, 0, 0, 3, 5, 0, 0, 0, 2],
      [4, 0, 4, 6, 0, 0, 0, 0, 0],
      [0, 0, 5, 0, 0, 0, 0, 6, 7],
      [0, 0, 0, 0, 3, 3, 7, 0, 0]
    ]
  },
  {
    "solution": [14, 28, 18, 10, 15, 21, 12, 20, 24],
    "hints": [
      [0, 0, 18, 0, 5, 3, 6, 0, 6],
      [1, 7, 1, 1, 3, 1, 1, 0, 1],
      [1, 1, 1, 1, 2, 1, 1, 2, 1],
      [1, 2, 1, 1, 5, 1, 1, 2, 1]
    ]
  },
  {
    "solution": [21, 28, 20, 15, 14, 10, 12, 24, 18],
    "hints": [
      [21, 0, 0, 15, 0, 0, 0, 0, 0],
      [1, 1, 1, 0, 14, 10, 0, 0, 6],
      [1, 1, 1, 2, 24, 6, 1, 1, 1],
      [1, 1, 1, 7, 1, 1, 1, 5, 1]
    ]
  },
  {
    "solution": [24, 21, 20, 18, 28, 15, 10, 12, 14],
    "hints": [
      [1, 1, 1, 0, 0, 5, 1, 0, 1],
      [4, 1, 1, 0, 1, 1, 2, 2, 1],
      [21, 5, 1, 28, 15, 1, 12, 7, 1]
    ]
  },
  {
    "solution": [24, 14, 15, 21, 10, 12, 28, 20, 18],
    "hints": [
      [14, 0, 1, 0, 0, 1, 0, 0, 1],
      [1, 1, 1, 0, 0, 0, 0, 0, 18],
      [1, 1, 1, 0, 0, 0, 28, 20, 0],
      [1, 1, 1, 0, 10, 12, 1, 1, 1],
      [1, 24, 1, 1, 21, 1, 1, 0, 1]
    ]
  },
  {
    "solution": [10, 28, 14, 15, 12, 18, 21, 24, 20],
    "hints": [
        [2, 7, 7, 0, 2, 0, 3, 0, 5],
        [1, 1, 3, 1, 0, 1, 1, 1, 1],
        [0, 1, 1, 0, 6, 6, 7, 1, 1],
        [1, 1, 1, 0, 0, 2, 3, 0, 0]
    ]
  },
  {
    "solution": [18, 12, 10, 24, 14, 28, 15, 21, 20],
    "hints": [
      [1, 10, 1, 0, 0, 1, 0, 1, 1],
      [1, 1, 1, 24, 0, 0, 1, 1, 20],
      [1, 1, 1, 18, 12, 1, 0, 1, 1],
      [1, 1, 1, 1, 0, 1, 0, 14, 28],
      [1, 1, 1, 0, 0, 0, 15, 1, 1],
      [0, 1, 1, 0, 0, 1, 21, 1, 1]
    ]
  },
  {
    "solution": [12, 10, 15, 18, 21, 28, 24, 14, 20],
    "hints": [
      [1, 1, 1, 18, 7, 1, 0, 14, 1],
      [1, 1, 1, 2, 3, 1, 7, 28, 1],
      [1, 6, 1, 1, 0, 1, 1, 24, 1]
    ]
  },
  {
    "solution": [18, 15, 28, 14, 21, 24, 10, 20, 12],
    "hints": [
      [0, 0, 4, 0, 0, 0, 0, 0, 0],
      [1, 1, 1, 15, 28, 1, 0, 24, 1],
      [18, 1, 1, 1, 3, 1, 1, 1, 1],
      [1, 1, 1, 10, 5, 6, 1, 1, 1]
    ]
  },
  {
    "solution": [28, 14, 10, 18, 12, 20, 21, 15, 24],
    "hints": [
      [0, 7, 2, 3, 0, 0, 3, 3, 0],
      [1, 1, 1, 0, 0, 5, 6, 2, 5],
      [7, 2, 1, 0, 0, 1, 0, 5, 1]
    ]
  },
  {
    "solution": [12, 24, 28, 14, 21, 20, 18, 15, 10],
    "hints": [
      [1, 4, 1, 2, 1, 1, 1, 3, 1],
      [1, 1, 1, 0, 5, 2, 1, 1, 1],
      [6, 0, 0, 7, 3, 5, 6, 0, 2],
      [2, 6, 1, 0, 0, 1, 0, 0, 1]
    ]
  },
  {
    "solution": [14, 15, 24, 12, 21, 20, 10, 18, 28],
    "hints": [
      [7, 0, 6, 0, 21, 0, 10, 6, 0],
      [12, 1, 1, 1, 0, 1, 1, 1, 1],
      [1, 1, 1, 3, 24, 1, 1, 1, 1],
      [7, 1, 1, 1, 24, 1, 1, 1, 1]
    ]
  },
  {
    "solution": [12, 24, 14, 21, 10, 15, 18, 20, 28],
    "hints": [
      [12, 0, 1, 1, 0, 1, 1, 0, 1],
      [1, 14, 1, 1, 15, 1, 1, 1, 1],
      [0, 1, 1, 0, 10, 1, 1, 0, 1],
      [1, 24, 1, 1, 0, 0, 1, 20, 1],
      [0, 1, 1, 21, 0, 1, 1, 0, 1],
      [0, 1, 1, 1, 0, 1, 1, 1, 28],
      [0, 0, 0, 18, 1, 1, 1, 1, 1]
    ]
  },
  {
    "solution": [12, 20, 28, 21, 15, 14, 18, 10, 24],
    "hints": [
      [12, 1, 1, 1, 0, 1, 1, 1, 0],
      [1, 1, 1, 1, 0, 1, 5, 2, 1],
      [0, 28, 1, 0, 0, 1, 0, 4, 1],
      [0, 0, 0, 6, 0, 0, 1, 1, 1],
      [7, 1, 1, 1, 10, 1, 1, 1, 1],
      [20, 1, 1, 1, 0, 1, 0, 1, 1]
    ]
  },
  {
    "solution": [20, 14, 10, 15, 28, 18, 24, 12, 21],
    "hints": [
      [5, 0, 5, 5, 0, 0, 0, 6, 7],
      [4, 2, 1, 1, 4, 1, 1, 2, 1],
      [1, 0, 1, 1, 3, 1, 1, 6, 1],
      [1, 0, 1, 1, 0, 1, 4, 0, 1]
    ]
  },
  {
    "solution": [14, 20, 10, 24, 15, 28, 21, 12, 18],
    "hints": [
      [7, 0, 1, 24, 1, 1, 0, 1, 1],
      [1, 1, 1, 7, 1, 1, 1, 3, 1],
      [0, 4, 0, 0, 0, 7, 3, 0, 6],
      [1, 0, 1, 1, 6, 1, 1, 7, 1],
      [0, 5, 1, 0, 28, 1, 0, 3, 1]
    ]
  },
  {
    "solution": [18, 21, 24, 10, 14, 20, 15, 12, 28],
    "hints": [
      [7, 4, 1, 7, 0, 1, 2, 7, 1],
      [1, 1, 1, 1, 21, 6, 1, 1, 1],
      [1, 6, 0, 1, 2, 2, 1, 3, 6]
    ]
  },
  {
    "solution": [21, 10, 24, 18, 12, 28, 15, 20, 14],
    "hints": [
      [0, 0, 6, 0, 6, 7, 0, 0, 7],
      [1, 7, 1, 1, 3, 1, 1, 0, 1],
      [3, 0, 0, 6, 0, 4, 1, 1, 1],
      [6, 2, 1, 3, 4, 1, 1, 1, 1]
    ]
  },
  {
    "solution": [24, 10, 14, 28, 15, 20, 12, 21, 18],
    "hints": [
      [1, 1, 1, 1, 1, 1, 4, 5, 7],
      [1, 1, 1, 0, 0, 2, 7, 0, 4],
      [1, 1, 1, 0, 5, 5, 0, 3, 0],
      [1, 3, 1, 2, 7, 1, 1, 1, 1]
    ]
  },
  {
    "solution": [15, 18, 10, 28, 24, 20, 12, 14, 21],
    "hints": [
      [5, 0, 1, 4, 4, 1, 0, 7, 1],
      [1, 1, 1, 0, 6, 5, 2, 2, 0],
      [0, 5, 1, 0, 4, 1, 0, 7, 1],
      [1, 1, 1, 5, 0, 2, 1, 1, 1]
    ]
  },
  {
    "solution": [20, 10, 18, 24, 12, 14, 28, 21, 15],
    "hints": [
      [2, 3, 1, 0, 0, 1, 0, 0, 1],
      [1, 1, 1, 7, 21, 3, 1, 1, 1],
      [1, 1, 1, 6, 2, 1, 3, 0, 1],
      [0, 5, 6, 0, 0, 1, 0, 1, 1],
      [1, 1, 1, 5, 5, 1, 1, 1, 1],
      [24, 0, 0, 0, 0, 0, 1, 1, 1]
    ]
  },
  {
    "solution": [28, 21, 20, 10, 24, 15, 12, 18, 14],
    "hints": [
      [1, 1, 1, 10, 4, 1, 1, 1, 1],
      [1, 1, 1, 3, 20, 1, 1, 1, 1],
      [0, 0, 1, 0, 6, 1, 2, 0, 1],
      [0, 0, 1, 0, 0, 1, 6, 12, 1],
      [7, 0, 1, 0, 0, 1, 3, 0, 1],
      [1, 1, 1, 2, 3, 1, 1, 1, 1],
      [3, 1, 1, 1, 3, 1, 1, 1, 1]
    ]
  }
]
